10 10
.........T
XX...XX...
X.........
X.XXXXX...
....XG...G
XX..XGX..G
....XXX...
XX...XX.K.
S....XX...
XXXXXXXXXX